28	0	1	0	1	0	0	2	G
33	0	0	0	1	0	1	2	G
38	1	0	0	0	1	0	2	G
49	0	0	0	0	0	2	2	C
61	0	2	0	0	0	1	3	T
68	1	0	0	0	0	2	3	A
86	0	0	2	0	1	0	3	C
89	0	0	0	0	0	3	3	A
91	1	3	0	0	0	0	4	T
100	0	0	0	3	0	2	5	G
105	0	0	3	0	2	0	5	C
113	4	2	0	0	0	0	6	A
131	0	5	0	0	0	2	7	T
137	0	2	0	6	0	0	8	G
140	0	6	0	0	0	2	8	T
149	0	0	0	2	6	0	8	G
168	3	0	7	0	0	0	10	A
179	8	0	0	0	0	0	8	C
201	0	3	0	0	6	0	9	T
241	2	0	0	5	0	0	7	G
261	2	0	0	0	0	4	6	A
285	4	3	0	0	0	0	7	A
289	0	4	0	0	2	0	6	T
295	2	0	0	4	0	0	6	G
297	0	0	4	2	0	0	6	G
300	6	0	0	0	0	0	6	G
305	0	0	4	2	0	0	6	C
307	4	0	2	0	0	0	6	A
310	2	4	0	0	0	0	6	T
321	0	2	3	0	0	0	5	C
322	0	0	0	5	0	0	5	A
330	0	0	0	0	5	0	5	A
350	3	1	0	0	0	0	4	T
358	0	0	2	5	0	0	7	G
374	0	8	0	0	0	0	8	A
383	0	5	0	0	0	2	7	T
386	3	0	0	0	0	4	7	A
393	0	0	2	4	0	0	6	C
394	0	0	4	2	0	0	6	C
395	2	0	0	4	0	0	6	G
399	0	0	5	0	1	0	6	C
400	2	0	0	0	5	0	7	A
436	7	0	0	0	3	0	10	A
437	3	6	0	0	0	0	9	A
442	0	0	0	5	0	3	8	G
450	0	3	0	0	0	5	8	T
455	5	0	3	0	0	0	8	C
458	0	0	3	0	5	0	8	C
459	5	0	0	0	3	0	8	A
462	0	0	0	0	8	0	8	C
464	7	3	0	0	0	0	10	A
466	5	0	5	0	0	0	10	A
471	0	0	5	0	0	6	11	C
492	0	12	0	0	0	0	12	C
496	6	0	0	0	6	0	12	A
497	11	0	0	0	1	0	12	A
504	2	0	0	0	0	9	11	A
510	0	0	4	0	5	0	9	C
519	0	0	0	1	7	0	8	G
521	7	0	0	0	1	0	8	A
546	0	7	2	0	0	0	9	T
563	0	7	0	0	0	0	7	A
566	0	0	6	0	0	0	6	A
578	0	0	6	0	0	0	6	G
579	0	1	0	0	5	0	6	T
581	6	0	0	0	1	0	7	A
608	0	0	5	0	0	1	6	C
626	1	2	0	0	0	0	3	A
628	2	1	0	0	0	0	3	T
632	0	0	1	0	0	2	3	C
636	2	0	0	0	1	0	3	A
641	0	2	1	0	0	0	3	G
642	0	0	0	2	0	1	3	A
644	0	1	0	0	0	2	3	T
661	0	0	0	0	3	0	3	A
684	0	0	4	0	0	2	6	C
699	0	0	0	0	0	5	5	A
701	0	0	2	3	0	0	5	C
727	0	2	2	0	0	0	4	T
741	0	4	0	0	0	0	4	A
743	0	0	2	3	0	0	5	C
749	0	0	0	7	0	0	7	T
752	0	4	3	0	0	0	7	C
754	0	3	0	4	0	0	7	G
764	0	5	0	0	1	0	6	T
773	4	0	0	0	0	0	4	G
775	0	0	4	0	0	0	4	A
779	0	1	3	0	0	0	4	C
786	0	0	0	5	0	0	5	C
798	0	0	5	0	0	0	5	G
800	5	0	0	0	0	0	5	G
810	0	3	0	0	0	2	5	T
812	0	3	0	2	0	0	5	G
815	0	3	0	0	0	2	5	T
816	2	2	0	0	0	0	4	A
846	0	4	0	0	0	0	4	G
854	0	0	0	2	0	2	4	G
867	2	0	2	0	0	0	4	A
871	0	0	0	0	0	4	4	G
895	0	0	3	1	0	0	4	C
904	0	0	0	2	0	0	2	C
920	0	0	1	0	0	0	1	G
929	0	0	1	0	0	0	1	G
946	0	0	0	0	1	0	1	C
963	0	0	0	0	0	1	1	T
967	0	0	0	0	1	0	1	T
972	0	0	0	1	0	0	1	A
