5	1	10	0	0	11	T
6	10	0	1	0	11	A
7	1	11	0	0	12	T
12	19	0	1	0	20	A
15	0	1	0	23	24	G
18	32	0	1	0	33	A
19	31	0	2	0	33	A
20	0	0	33	2	35	C
21	0	0	35	2	37	C
22	0	0	38	2	40	C
23	0	1	0	40	41	G
26	0	0	43	2	45	C
30	0	0	53	1	54	C
31	53	0	2	0	55	A
32	56	0	1	0	57	A
33	0	2	0	57	59	G
34	0	3	0	58	61	G
37	0	0	68	1	69	C
38	0	1	0	70	71	G
39	0	1	0	75	76	G
40	3	75	0	0	78	T
41	80	0	1	0	81	A
42	0	0	79	6	85	C
45	0	5	0	88	93	G
46	92	0	2	0	94	A
47	0	0	93	1	94	C
49	0	0	94	4	98	C
50	99	0	1	0	100	A
51	0	1	0	101	102	G
52	0	0	98	4	102	C
53	0	3	0	102	105	G
54	0	0	102	4	106	C
55	105	0	2	0	107	A
57	0	2	0	111	113	G
58	0	0	114	4	118	C
59	0	0	118	1	119	C
60	4	115	0	0	119	T
61	3	119	0	0	122	T
62	0	0	120	3	123	C
63	118	0	6	0	124	A
64	122	0	4	0	126	A
65	0	2	0	126	128	G
66	0	1	0	131	132	G
67	5	132	0	0	137	T
69	0	3	0	136	139	G
70	139	0	3	0	142	A
71	0	4	0	139	143	G
72	0	0	142	3	145	C
73	0	0	146	2	148	C
74	3	147	0	0	150	T
75	0	0	148	4	152	C
76	1	152	0	0	153	T
77	0	0	154	1	155	C
78	3	152	0	0	155	T
79	0	0	155	2	157	C
80	0	0	151	8	159	C
81	1	159	0	0	160	T
82	0	4	0	158	162	G
83	0	0	158	4	162	C
84	0	2	0	163	165	G
86	0	0	162	6	168	C
87	0	6	0	163	169	G
88	168	0	3	0	171	A
89	170	0	5	0	175	A
90	2	175	0	0	177	T
91	1	178	0	0	179	T
92	5	175	0	0	180	T
93	0	6	0	179	185	G
94	2	188	0	0	190	T
96	0	0	184	7	191	C
97	0	0	188	5	193	C
98	0	2	0	192	194	G
99	0	0	196	2	198	C
100	0	4	0	194	198	G
101	0	1	0	200	201	G
102	0	4	0	201	205	G
103	0	0	200	6	206	C
104	4	203	0	0	207	T
105	0	0	200	7	207	C
106	206	0	4	0	210	A
107	7	206	0	0	213	T
108	213	0	3	0	216	A
109	0	6	0	212	218	G
110	5	214	0	0	219	T
111	1	218	0	0	219	T
112	0	6	0	216	222	G
113	218	0	8	0	226	A
114	5	222	0	0	227	T
115	4	227	0	0	231	T
116	0	1	0	232	233	G
117	0	3	0	230	233	G
118	3	232	0	0	235	T
119	0	0	228	10	238	C
120	0	5	0	236	241	G
121	4	238	0	0	242	T
122	0	0	238	5	243	C
123	0	3	0	242	245	G
124	0	0	240	10	250	C
125	0	0	245	5	250	C
126	0	4	0	248	252	G
127	4	249	0	0	253	T
128	0	0	246	7	253	C
129	0	0	251	3	254	C
130	251	0	7	0	258	A
131	12	251	0	0	263	T
132	0	2	0	263	265	G
133	0	3	0	265	268	G
134	5	265	0	0	270	T
135	4	266	0	0	270	T
136	0	3	0	268	271	G
137	0	6	0	265	271	G
138	264	0	8	0	272	A
139	0	5	0	267	272	G
140	6	266	0	0	272	T
141	268	0	9	0	277	A
142	3	275	0	0	278	T
143	0	9	0	274	283	G
144	280	0	3	0	283	A
145	273	0	11	0	284	A
146	4	282	0	0	286	T
147	5	285	0	0	290	T
148	0	0	286	5	291	C
149	0	12	0	282	294	G
150	288	0	7	0	295	A
151	292	0	4	0	296	A
152	9	287	0	0	296	T
153	0	3	0	292	295	G
154	0	0	289	7	296	C
155	0	7	0	290	297	G
156	0	0	294	7	301	C
157	0	6	0	296	302	G
158	10	292	0	0	302	T
159	303	0	3	0	306	A
160	8	297	0	0	305	T
161	0	0	301	5	306	C
162	0	0	302	7	309	C
163	303	0	5	0	308	A
164	0	7	0	301	308	G
165	0	0	303	6	309	C
166	7	299	0	0	306	T
167	0	0	297	5	302	C
168	297	0	4	0	301	A
169	0	3	0	300	303	G
170	5	297	0	0	302	T
171	0	0	298	4	302	C
172	0	0	292	10	302	C
173	299	0	5	0	304	A
174	0	0	298	6	304	C
175	0	0	300	5	305	C
176	0	0	301	6	307	C
177	0	0	300	7	307	C
178	300	0	8	0	308	A
179	0	0	302	5	307	C
180	0	8	0	300	308	G
181	7	302	0	0	309	T
182	0	0	301	9	310	C
183	303	0	6	0	309	A
184	6	303	0	0	309	T
185	298	0	7	0	305	A
186	0	11	0	296	307	G
187	0	0	304	2	306	C
188	0	0	300	6	306	C
189	0	0	295	8	303	C
190	300	0	4	0	304	A
191	0	0	299	3	302	C
192	4	296	0	0	300	T
193	0	4	0	296	300	G
194	0	8	0	292	300	G
195	4	294	0	0	298	T
196	5	294	0	0	299	T
197	0	0	298	3	301	C
198	8	294	0	0	302	T
199	290	0	9	0	299	A
200	7	292	0	0	299	T
201	10	290	0	0	300	T
202	298	0	3	0	301	A
203	0	3	0	297	300	G
204	0	3	0	297	300	G
205	0	0	302	3	305	C
206	295	0	9	0	304	A
207	0	0	297	5	302	C
208	4	294	0	0	298	T
209	288	0	9	0	297	A
210	0	0	293	4	297	C
211	0	0	289	6	295	C
212	7	289	0	0	296	T
213	6	288	0	0	294	T
214	143	148	4	0	295	A
215	0	0	290	5	295	C
216	0	6	0	285	291	G
217	282	0	6	0	288	A
218	0	0	285	2	287	C
219	6	282	0	0	288	T
220	280	0	9	0	289	A
221	0	5	0	285	290	G
222	6	286	0	0	292	T
223	0	0	285	5	290	C
224	286	0	4	0	290	A
225	284	0	6	0	290	A
226	288	0	4	0	292	A
227	285	0	6	0	291	A
228	283	0	10	0	293	A
229	285	0	7	0	292	A
230	287	0	7	0	294	A
231	5	289	0	0	294	T
232	2	291	0	0	293	T
233	0	0	283	11	294	C
234	288	0	3	0	291	A
235	286	0	4	0	290	A
236	0	0	288	4	292	C
237	287	0	6	0	293	A
238	0	9	0	285	294	G
239	0	0	286	6	292	C
240	4	290	0	0	294	T
241	0	4	0	290	294	G
242	0	6	0	290	296	G
243	0	5	0	288	293	G
244	288	0	3	0	291	A
245	8	289	0	0	297	T
246	4	293	0	0	297	T
247	6	292	0	0	298	T
248	0	0	289	8	297	C
249	6	291	0	0	297	T
250	298	0	2	0	300	A
251	0	4	0	294	298	G
252	0	5	0	289	294	G
253	0	0	290	8	298	C
254	0	7	0	291	298	G
255	0	5	0	294	299	G
256	293	0	6	0	299	A
257	0	8	0	291	299	G
258	7	291	0	0	298	T
259	0	5	0	293	298	G
260	0	0	291	6	297	C
261	293	0	5	0	298	A
262	5	291	0	0	296	T
263	288	0	6	0	294	A
264	0	4	0	291	295	G
265	0	4	0	291	295	G
266	290	1	2	0	293	A
267	0	0	288	7	295	C
268	0	6	1	286	293	G
269	0	0	288	4	292	C
270	0	6	0	286	292	G
271	284	0	8	0	292	A
272	2	291	0	0	293	T
273	8	286	0	0	294	T
274	287	0	4	0	291	A
275	285	0	6	0	291	A
276	0	0	282	10	292	C
277	1	0	289	6	296	C
278	0	3	0	298	301	G
279	297	0	4	0	301	A
280	0	7	0	291	298	G
281	286	0	9	0	295	A
282	0	4	0	292	296	G
283	289	0	4	0	293	A
284	0	0	284	10	294	C
285	287	0	8	0	295	A
286	291	0	8	0	299	A
287	299	0	3	0	302	A
288	0	2	0	300	302	G
289	1	302	0	0	303	T
290	0	0	301	5	306	C
291	293	0	9	0	302	A
292	3	298	0	0	301	T
293	0	6	0	293	299	G
294	2	297	0	0	299	T
295	0	6	0	298	304	G
296	0	10	0	295	305	G
297	0	8	0	296	304	G
298	300	0	6	0	306	A
299	300	1	4	0	305	A
300	0	4	0	304	308	G
301	1	0	300	8	309	C
302	0	4	0	305	309	G
303	0	4	1	303	308	G
304	0	9	1	297	307	G
305	0	0	307	1	308	C
306	0	0	302	4	306	C
307	294	0	10	0	304	A
308	292	0	12	0	304	A
309	297	0	5	0	302	A
310	4	300	0	0	304	T
311	11	292	0	0	303	T
312	0	10	1	292	303	G
313	0	0	300	5	305	C
314	6	302	0	0	308	T
315	4	302	0	0	306	T
316	12	295	0	0	307	T
317	0	5	0	306	311	G
318	306	0	5	0	311	A
319	0	4	0	306	310	G
320	0	4	0	306	310	G
321	1	0	306	4	311	C
322	306	1	5	0	312	A
323	0	8	2	304	314	G
324	0	5	1	309	315	G
325	7	306	0	0	313	T
326	0	0	304	5	309	C
327	2	306	0	0	308	T
328	0	5	1	301	307	G
329	6	303	0	0	309	T
330	305	0	4	0	309	A
331	0	4	0	304	308	G
332	4	305	0	0	309	T
333	0	5	0	305	310	G
334	5	304	0	0	309	T
335	3	306	0	0	309	T
336	304	0	7	0	311	A
337	0	4	0	310	314	G
338	0	0	311	3	314	C
339	4	312	0	1	317	T
340	309	0	7	0	316	A
341	0	0	309	9	318	C
342	0	4	0	314	318	G
343	305	1	11	0	317	A
344	0	0	313	6	319	C
345	317	0	3	0	320	A
346	0	0	317	3	320	C
347	1	0	315	4	320	C
348	314	0	6	0	320	A
349	6	319	0	1	326	T
350	6	318	0	1	325	T
351	0	7	1	318	326	G
352	0	5	1	322	328	G
353	5	325	0	0	330	T
354	326	0	6	0	332	A
355	0	13	0	314	327	G
356	320	2	6	0	328	A
357	2	328	0	2	332	T
358	0	7	0	326	333	G
359	10	324	0	0	334	T
360	332	1	4	0	337	A
361	6	333	0	1	340	T
362	1	0	338	2	341	C
363	0	0	338	8	346	C
364	5	337	0	3	345	T
365	344	0	2	0	346	A
366	337	2	12	0	351	A
367	346	1	4	0	351	A
368	349	0	6	0	355	A
369	1	353	0	3	357	T
370	4	355	0	0	359	T
371	0	9	0	352	361	G
372	0	5	3	355	363	G
373	1	0	354	8	363	C
374	359	1	5	0	365	A
375	359	3	8	0	370	A
376	2	0	363	5	370	C
377	0	0	367	4	371	C
378	366	1	6	0	373	A
379	372	4	3	0	379	A
380	0	5	4	375	384	G
381	376	0	9	0	385	A
382	3	0	375	8	386	C
383	7	381	0	0	388	T
384	387	1	4	0	392	A
385	5	385	0	3	393	T
386	395	0	5	0	400	A
387	1	0	391	7	399	C
388	386	2	9	0	397	A
389	388	1	7	0	396	A
390	2	395	0	1	398	T
391	390	2	6	0	398	A
392	0	7	1	391	399	G
393	1	0	395	4	400	C
394	1	0	391	7	399	C
395	0	1	3	391	395	G
396	389	2	8	0	399	A
397	3	0	392	4	399	C
398	396	3	2	0	401	A
399	2	0	389	7	398	C
400	395	0	3	0	398	A
401	391	2	8	0	401	A
402	399	2	5	0	406	A
403	3	397	0	4	404	T
404	0	4	5	396	405	G
405	395	1	11	0	407	A
406	401	2	4	0	407	A
407	404	1	4	0	409	A
408	2	0	404	4	410	C
409	4	409	0	2	415	T
410	414	0	3	0	417	A
411	3	0	408	7	418	C
412	3	417	0	3	423	T
413	0	0	420	5	425	C
414	6	420	0	1	427	T
415	0	6	3	421	430	G
416	6	426	0	4	436	T
417	0	9	0	427	436	G
418	427	8	4	0	439	A
419	0	7	3	429	439	G
420	2	0	426	9	437	C
421	1	0	433	4	438	C
422	433	4	3	0	440	A
423	3	0	434	5	442	C
424	5	438	0	1	444	T
425	7	433	0	6	446	T
426	438	4	4	0	446	A
427	0	9	2	438	449	G
428	437	3	5	0	445	A
429	3	0	437	6	446	C
430	3	446	0	1	450	T
431	4	0	438	9	451	C
432	3	446	0	3	452	T
433	452	2	5	0	459	A
434	450	2	7	0	459	A
435	1	0	456	5	462	C
436	457	0	2	0	459	A
437	441	8	10	0	459	A
438	452	6	3	0	461	A
439	456	3	3	0	462	A
440	0	5	1	456	462	G
441	5	0	459	4	468	C
442	0	8	2	460	470	G
443	0	9	5	457	471	G
444	469	2	6	0	477	A
445	0	3	3	470	476	G
446	0	3	6	468	477	G
447	4	0	472	2	478	C
448	3	0	471	7	481	C
449	3	0	478	6	487	C
450	11	473	0	2	486	T
451	0	13	5	469	487	G
452	478	3	7	0	488	A
453	0	5	2	484	491	G
454	6	0	480	7	493	C
455	3	0	487	7	497	C
456	6	490	0	3	499	T
457	0	9	7	487	503	G
458	6	0	492	5	503	C
459	498	3	6	0	507	A
460	3	0	494	7	504	C
461	0	11	4	493	508	G
462	6	0	499	4	509	C
463	7	0	494	6	507	C
464	492	4	9	0	505	A
465	495	4	8	0	507	A
466	499	6	5	0	510	A
467	503	3	8	0	514	A
468	3	0	505	9	517	C
469	5	0	505	9	519	C
470	512	6	3	0	521	A
471	0	0	515	4	519	C
472	4	505	0	6	515	T
473	10	492	0	9	511	T
474	0	5	7	504	516	G
475	9	505	0	4	518	T
476	504	5	12	0	521	A
477	4	0	520	3	527	C
478	0	8	7	513	528	G
479	4	514	0	7	525	T
480	6	0	513	6	525	C
481	6	518	0	3	527	T
482	0	8	2	515	525	G
483	4	515	0	6	525	T
484	4	0	518	4	526	C
485	8	517	0	1	526	T
486	0	4	4	516	524	G
487	3	0	515	5	523	C
488	0	4	7	515	526	G
489	5	0	516	2	523	C
490	8	0	512	5	525	C
491	0	8	1	514	523	G
492	7	0	511	6	524	C
493	0	4	4	516	524	G
494	516	3	4	0	523	A
495	7	510	0	8	525	T
496	520	3	2	0	525	A
497	519	5	5	0	529	A
498	2	521	0	8	531	T
499	7	519	0	3	529	T
500	0	6	9	514	529	G
501	6	0	518	5	529	C
502	0	3	5	526	534	G
503	520	9	2	0	531	A
504	518	3	9	0	530	A
505	3	0	525	5	533	C
506	0	6	2	525	533	G
507	0	2	2	525	529	G
508	0	2	2	527	531	G
509	9	520	0	1	530	T
510	11	0	514	5	530	C
511	0	3	8	518	529	G
512	7	0	513	7	527	C
513	4	0	517	4	525	C
514	0	2	8	514	524	G
515	0	9	4	509	522	G
516	5	513	0	3	521	T
517	5	0	517	6	528	C
518	517	1	7	0	525	A
519	0	5	6	514	525	G
520	514	6	4	0	524	A
521	504	9	8	0	521	A
522	0	4	1	517	522	G
523	0	7	5	511	523	G
524	0	8	2	513	523	G
525	3	512	0	4	519	T
526	6	0	506	8	520	C
527	0	2	7	509	518	G
528	6	503	0	6	515	T
529	3	0	505	3	511	C
530	5	495	0	6	506	T
531	499	4	3	0	506	A
532	9	0	495	4	508	C
533	501	8	0	0	509	A
534	2	0	500	3	505	C
535	6	0	492	6	504	C
536	5	489	0	3	497	T
537	5	486	0	8	499	T
538	3	0	491	6	500	C
539	3	490	0	6	499	T
540	0	6	7	480	493	G
541	9	0	485	3	497	C
542	0	6	10	478	494	G
543	6	477	0	10	493	T
544	6	0	486	0	492	C
545	0	6	8	477	491	G
546	1	482	0	5	488	T
547	0	2	6	480	488	G
548	4	0	482	4	490	C
549	5	482	0	5	492	T
550	477	10	5	0	492	A
551	5	0	484	1	490	C
552	6	476	0	5	487	T
553	4	473	0	7	484	T
554	3	474	0	7	484	T
555	473	4	5	0	482	A
556	0	10	6	464	480	G
557	4	472	0	1	477	T
558	0	3	3	469	475	G
559	0	5	6	458	469	G
560	0	2	7	459	468	G
561	4	461	0	3	468	T
562	3	455	0	5	463	T
563	456	4	3	0	463	A
564	0	5	7	450	462	G
565	454	4	0	0	458	A
566	442	8	3	0	453	A
567	0	3	5	444	452	G
568	439	10	4	0	453	A
569	4	442	0	6	452	T
570	4	444	0	6	454	T
571	7	0	443	5	455	C
572	2	449	0	6	457	T
573	439	7	7	0	453	A
574	0	2	5	445	452	G
575	4	443	0	4	451	T
576	0	3	4	444	451	G
577	431	8	5	0	444	A
578	0	10	4	431	445	G
579	2	436	0	6	444	T
580	433	4	2	0	439	A
581	431	5	2	0	438	A
582	427	5	3	0	435	A
583	421	7	2	0	430	A
584	0	2	9	419	430	G
585	0	3	5	422	430	G
586	1	423	0	5	429	T
587	11	0	414	3	428	C
588	2	415	0	8	425	T
589	0	2	4	418	424	G
590	416	2	5	0	423	A
591	2	411	0	4	417	T
592	3	0	413	2	418	C
593	8	0	405	3	416	C
594	6	0	403	2	411	C
595	4	400	0	4	408	T
596	400	5	2	0	407	A
597	6	0	398	0	404	C
598	4	0	391	4	399	C
599	4	0	391	0	395	C
600	387	2	2	0	391	A
601	0	387	0	5	392	T
602	4	380	0	4	388	T
603	0	382	0	4	386	T
604	2	370	0	10	382	T
605	4	0	374	0	378	C
606	365	9	1	0	375	A
607	2	368	0	1	371	T
608	7	0	363	1	371	C
609	3	361	0	5	369	T
610	4	362	0	5	371	T
611	5	0	361	1	367	C
612	0	2	2	359	363	G
613	1	0	361	1	363	C
614	355	6	4	0	365	A
615	360	5	2	0	367	A
616	1	360	0	4	365	T
617	355	2	1	0	358	A
618	0	351	0	4	355	T
619	341	9	3	0	353	A
620	347	4	1	0	352	A
621	349	5	0	0	354	A
622	1	348	0	6	355	T
623	345	9	1	0	355	A
624	1	342	0	6	349	T
625	340	6	1	0	347	A
626	342	4	0	0	346	A
627	2	329	0	8	339	T
628	1	328	0	7	336	T
629	328	8	1	0	337	A
630	0	331	0	6	337	T
631	0	331	0	7	338	T
632	3	0	330	5	338	C
633	0	1	8	329	338	G
634	0	337	0	2	339	T
635	5	0	334	1	340	C
636	331	5	1	0	337	A
637	1	330	0	6	337	T
638	0	1	6	329	336	G
639	0	335	0	4	339	T
640	0	1	3	334	338	G
641	0	0	7	333	340	G
642	335	2	2	0	339	A
643	3	0	335	1	339	C
644	1	334	0	2	337	T
645	9	0	322	1	332	C
646	7	0	324	1	332	C
647	0	3	5	319	327	G
648	4	0	320	1	325	C
649	317	7	1	0	325	A
650	0	3	13	311	327	G
651	7	0	315	2	324	C
652	312	6	0	0	318	A
653	7	0	311	0	318	C
654	312	4	2	0	318	A
655	3	0	313	1	317	C
656	3	0	316	0	319	C
657	2	0	318	0	320	C
658	315	4	0	0	319	A
659	9	0	313	0	322	C
660	6	0	312	1	319	C
661	311	9	0	0	320	A
662	310	11	1	0	322	A
663	1	313	0	6	320	T
664	311	9	1	0	321	A
665	0	1	10	311	322	G
666	4	0	317	0	321	C
667	308	6	0	0	314	A
668	305	9	0	0	314	A
669	0	1	7	302	310	G
670	0	301	0	5	306	T
671	0	298	0	8	306	T
672	0	0	4	296	300	G
673	0	2	5	294	301	G
674	0	298	0	3	301	T
675	1	295	0	4	300	T
676	294	2	0	0	296	A
677	4	0	294	0	298	C
678	0	293	0	6	299	T
679	0	0	5	291	296	G
680	286	9	0	0	295	A
681	5	0	292	0	297	C
682	0	0	8	286	294	G
683	3	0	290	1	294	C
684	6	0	291	0	297	C
685	0	0	6	292	298	G
686	0	295	0	3	298	T
687	0	1	3	295	299	G
688	289	8	0	0	297	A
689	0	0	6	292	298	G
690	8	0	292	0	300	C
691	5	0	293	1	299	C
692	5	0	293	0	298	C
693	0	0	6	294	300	G
694	0	293	0	7	300	T
695	6	0	293	1	300	C
696	291	7	0	0	298	A
697	291	5	0	0	296	A
698	8	0	285	0	293	C
699	286	6	0	0	292	A
700	4	0	285	2	291	C
701	3	0	287	0	290	C
702	4	0	286	1	291	C
703	3	0	291	1	295	C
704	0	290	0	5	295	T
705	0	293	0	5	298	T
706	297	3	0	0	300	A
707	0	294	0	7	301	T
708	8	0	294	0	302	C
709	11	0	291	0	302	C
710	292	7	1	0	300	A
711	6	0	294	0	300	C
712	0	298	0	3	301	T
713	0	292	0	7	299	T
714	1	291	0	4	296	T
715	7	0	287	0	294	C
716	0	0	7	288	295	G
717	5	0	292	0	297	C
718	295	4	0	0	299	A
719	4	0	295	0	299	C
720	0	291	0	5	296	T
721	0	290	0	6	296	T
722	288	6	0	0	294	A
723	0	0	4	291	295	G
724	0	0	4	289	293	G
725	4	0	290	0	294	C
726	281	10	1	0	292	A
727	0	290	0	2	292	T
728	290	2	0	0	292	A
729	0	286	0	7	293	T
730	290	4	0	0	294	A
731	0	0	12	284	296	G
732	0	0	5	291	296	G
733	9	0	286	0	295	C
734	0	285	0	8	293	T
735	8	0	281	0	289	C
736	0	0	13	278	291	G
737	0	0	7	283	290	G
738	284	10	0	0	294	A
739	0	289	0	4	293	T
740	0	288	0	6	294	T
741	288	6	0	0	294	A
742	289	3	0	0	292	A
743	5	0	286	0	291	C
744	9	0	283	0	292	C
745	288	5	0	0	293	A
746	287	6	0	0	293	A
747	3	0	294	0	297	C
748	0	288	0	9	297	T
749	0	286	0	9	295	T
750	7	0	290	0	297	C
751	7	0	286	0	293	C
752	8	0	286	0	294	C
753	284	11	0	0	295	A
754	0	0	7	291	298	G
755	3	0	295	0	298	C
756	291	6	0	0	297	A
757	6	0	293	0	299	C
758	6	0	293	0	299	C
759	289	7	0	0	296	A
760	6	0	290	0	296	C
761	291	4	0	0	295	A
762	0	293	0	3	296	T
763	0	0	4	294	298	G
764	0	294	0	3	297	T
765	0	0	4	291	295	G
766	0	293	0	5	298	T
767	292	7	0	0	299	A
768	0	298	0	3	301	T
769	5	0	297	0	302	C
770	9	0	292	0	301	C
771	0	296	0	5	301	T
772	0	293	0	8	301	T
773	0	0	5	301	306	G
774	0	294	0	12	306	T
775	304	3	0	0	307	A
776	0	299	0	8	307	T
777	299	8	0	0	307	A
778	0	0	6	304	310	G
779	6	0	304	0	310	C
780	5	0	307	0	312	C
781	0	0	3	306	309	G
782	0	302	0	5	307	T
783	7	0	299	0	306	C
784	3	0	300	0	303	C
785	0	0	3	301	304	G
786	4	0	301	0	305	C
787	8	0	296	0	304	C
788	7	0	296	0	303	C
789	0	295	0	6	301	T
790	6	0	295	0	301	C
791	297	3	0	0	300	A
792	0	294	0	7	301	T
793	0	0	7	292	299	G
794	296	3	0	0	299	A
795	7	0	295	0	302	C
796	0	292	0	9	301	T
797	296	5	0	0	301	A
798	0	0	5	296	301	G
799	0	0	8	294	302	G
800	0	0	1	300	301	G
801	0	297	0	4	301	T
802	0	0	5	297	302	G
803	0	0	7	299	306	G
804	4	0	301	0	305	C
805	0	0	3	300	303	G
806	291	10	0	0	301	A
807	0	0	4	300	304	G
808	0	294	0	9	303	T
809	296	5	0	0	301	A
810	0	296	0	5	301	T
811	0	0	8	291	299	G
812	0	0	2	300	302	G
813	0	0	8	293	301	G
814	0	0	12	287	299	G
815	0	298	0	5	303	T
816	297	5	0	0	302	A
817	0	0	8	297	305	G
818	0	0	3	305	308	G
819	303	5	0	0	308	A
820	5	0	304	0	309	C
821	6	0	305	0	311	C
822	309	5	0	0	314	A
823	0	308	0	5	313	T
824	0	311	0	2	313	T
825	0	308	0	4	312	T
826	0	0	8	307	315	G
827	0	308	0	5	313	T
828	0	304	0	7	311	T
829	0	307	0	8	315	T
830	4	0	310	0	314	C
831	4	0	308	0	312	C
832	310	3	0	0	313	A
833	305	7	0	0	312	A
834	305	7	0	0	312	A
835	303	8	0	0	311	A
836	309	3	0	0	312	A
837	0	0	6	305	311	G
838	0	0	5	307	312	G
839	0	305	0	7	312	T
840	0	0	7	303	310	G
841	0	303	0	3	306	T
842	0	0	9	304	313	G
843	0	310	0	4	314	T
844	308	11	0	0	319	A
845	315	5	0	0	320	A
846	0	0	3	317	320	G
847	0	0	5	314	319	G
848	8	0	314	0	322	C
849	315	6	0	0	321	A
850	0	316	0	3	319	T
851	6	0	312	0	318	C
852	0	0	7	308	315	G
853	306	5	0	0	311	A
854	0	0	5	305	310	G
855	6	0	301	0	307	C
856	6	0	298	0	304	C
857	9	0	292	0	301	C
858	295	4	0	0	299	A
859	8	0	290	0	298	C
860	287	10	0	0	297	A
861	288	7	0	0	295	A
862	0	286	0	7	293	T
863	286	5	0	0	291	A
864	284	7	0	0	291	A
865	283	8	0	0	291	A
866	6	0	283	0	289	C
867	280	6	0	0	286	A
868	0	0	6	275	281	G
869	276	4	0	0	280	A
870	0	273	0	7	280	T
871	0	0	5	272	277	G
872	269	4	0	0	273	A
873	9	0	262	0	271	C
874	5	0	265	0	270	C
875	0	0	3	264	267	G
876	4	0	262	0	266	C
877	0	0	7	258	265	G
878	0	0	3	260	263	G
879	257	5	0	0	262	A
880	0	0	5	256	261	G
881	0	251	0	6	257	T
882	0	251	0	5	256	T
883	0	0	6	249	255	G
884	0	0	4	250	254	G
885	0	0	2	252	254	G
886	0	241	0	10	251	T
887	7	0	243	0	250	C
888	4	0	242	0	246	C
889	6	0	240	0	246	C
890	3	0	239	0	242	C
891	0	238	0	3	241	T
892	0	237	0	4	241	T
893	0	0	7	233	240	G
894	0	232	0	5	237	T
895	4	0	230	0	234	C
896	5	0	226	0	231	C
897	0	0	7	219	226	G
898	0	0	4	221	225	G
899	222	2	0	0	224	A
900	215	7	0	0	222	A
901	0	216	0	5	221	T
902	0	215	0	4	219	T
903	0	0	3	213	216	G
904	4	0	209	0	213	C
905	0	207	0	4	211	T
906	0	0	1	210	211	G
907	0	0	6	202	208	G
908	201	5	0	0	206	A
909	0	0	1	204	205	G
910	9	0	194	0	203	C
911	198	4	0	0	202	A
912	193	7	0	0	200	A
913	7	0	190	0	197	C
914	0	188	0	6	194	T
916	0	181	0	6	187	T
917	0	0	1	184	185	G
918	0	180	0	2	182	T
919	0	0	6	174	180	G
920	0	0	4	175	179	G
921	0	173	0	3	176	T
923	0	165	0	4	169	T
924	3	0	165	0	168	C
925	0	165	0	2	167	T
926	3	0	162	0	165	C
927	0	160	0	4	164	T
928	155	6	0	0	161	A
929	0	0	3	156	159	G
930	0	0	4	151	155	G
931	2	0	151	0	153	C
932	0	149	0	4	153	T
933	0	150	0	2	152	T
934	5	0	147	0	152	C
935	4	0	144	0	148	C
936	145	2	0	0	147	A
937	0	143	0	2	145	T
938	1	0	140	0	141	C
939	136	2	0	0	138	A
940	2	0	135	0	137	C
941	134	2	0	0	136	A
942	0	0	1	132	133	G
943	4	0	129	0	133	C
944	130	2	0	0	132	A
945	1	0	127	0	128	C
946	4	0	123	0	127	C
947	123	2	0	0	125	A
948	2	0	121	0	123	C
949	0	0	3	116	119	G
950	0	117	0	1	118	T
951	0	0	2	115	117	G
954	107	2	0	0	109	A
955	0	104	0	4	108	T
956	0	102	0	3	105	T
959	0	94	0	3	97	T
960	94	2	0	0	96	A
961	0	92	0	1	93	T
962	0	86	0	1	87	T
963	0	86	0	1	87	T
964	1	0	86	0	87	C
965	81	1	0	0	82	A
966	0	78	0	2	80	T
968	0	0	4	68	72	G
969	70	2	0	0	72	A
970	68	2	0	0	70	A
971	65	2	0	0	67	A
973	0	0	1	60	61	G
974	1	0	57	0	58	C
975	0	56	0	1	57	T
976	0	53	0	1	54	T
978	0	0	1	52	53	G
980	0	47	0	1	48	T
981	43	3	0	0	46	A
982	1	0	43	0	44	C
984	35	3	0	0	38	A
987	0	0	2	28	30	G
988	0	25	0	3	28	T
990	26	1	0	0	27	A
991	0	25	0	1	26	T
