0	0	0	1	0	0	0	1	G
42	73	0	0	0	0	0	73	C
46	81	0	1	0	0	0	82	A
57	0	1	0	100	0	0	101	G
60	1	104	0	0	0	0	105	T
61	0	0	0	106	0	0	106	T
75	0	0	142	1	0	0	143	C
79	0	0	150	1	0	0	151	C
88	103	0	0	68	0	0	171	A
92	1	175	0	0	0	0	176	T
99	0	0	188	1	0	0	189	C
106	203	0	1	0	0	0	204	A
115	1	224	0	0	0	0	225	T
120	101	0	0	129	0	0	230	G
124	0	0	238	1	0	0	239	C
127	1	242	0	0	0	0	243	T
141	276	0	1	0	0	0	277	A
145	280	0	1	0	1	0	282	A
147	1	128	0	0	154	0	283	T
154	0	0	279	1	0	0	280	C
156	0	0	279	1	0	0	280	C
159	280	0	1	0	0	0	281	A
164	0	1	0	285	0	0	286	G
166	1	281	0	0	0	0	282	T
171	0	0	276	1	0	0	277	C
173	273	0	1	0	0	0	274	A
175	119	0	151	0	0	0	270	C
178	272	0	1	0	0	0	273	A
179	0	0	275	1	0	0	276	C
185	281	0	1	0	0	0	282	A
191	0	0	284	2	0	0	286	C
203	0	1	0	287	0	0	288	G
209	288	0	1	0	0	0	289	A
213	1	289	0	0	0	0	290	T
218	0	0	289	1	0	0	290	C
222	145	138	0	0	0	0	283	T
225	136	0	144	0	0	0	280	A
226	283	0	1	0	0	0	284	A
235	9	0	0	0	0	280	289	A
236	6	0	280	0	0	0	286	C
239	0	0	288	1	0	0	289	C
246	2	287	0	0	0	0	289	T
247	143	148	0	0	0	0	291	T
250	293	0	1	0	0	0	294	A
251	0	1	0	295	0	0	296	G
254	0	1	0	298	0	0	299	G
262	1	287	0	0	0	0	288	T
263	0	0	290	0	0	0	290	A
267	0	0	295	1	0	0	296	C
269	0	0	297	1	0	0	298	C
270	0	1	0	298	0	0	299	G
271	297	0	1	0	0	0	298	A
273	1	298	0	0	0	0	299	T
277	0	0	303	1	0	0	304	C
278	0	2	0	301	0	0	303	G
281	301	0	1	0	0	0	302	A
283	299	0	1	0	0	0	300	A
288	0	0	160	138	0	0	298	G
291	296	1	0	0	0	0	297	A
295	0	2	0	297	0	0	299	G
296	0	1	0	301	0	0	302	G
305	0	0	317	1	0	0	318	C
307	320	0	1	0	0	0	321	A
308	318	0	1	0	0	0	319	A
314	1	320	0	0	0	0	321	T
315	1	319	0	0	0	0	320	T
316	1	319	0	0	0	0	320	T
318	317	0	1	0	0	0	318	A
319	0	2	0	317	0	0	319	G
326	0	0	340	1	0	0	341	C
328	0	159	0	179	0	0	338	G
330	339	1	0	0	0	0	340	A
331	0	2	0	325	11	0	338	G
332	1	175	0	0	162	0	338	T
333	1	0	0	333	0	0	334	G
339	1	337	0	0	0	0	338	T
341	0	341	0	0	0	0	341	C
344	0	0	339	1	0	0	340	C
345	338	0	1	0	0	0	339	A
346	0	0	340	2	0	0	342	C
348	345	0	2	0	0	0	347	A
354	353	1	0	0	0	0	354	A
355	0	1	0	350	0	0	351	G
362	0	0	355	1	0	0	356	C
365	356	0	1	0	0	0	357	A
389	389	1	1	0	0	0	391	A
390	1	389	0	0	0	0	390	T
395	0	0	1	394	0	0	395	G
400	392	1	1	0	0	0	394	A
401	398	0	1	0	0	0	399	A
405	402	1	0	0	0	0	403	A
407	404	0	1	0	0	0	405	A
409	0	401	0	1	0	0	402	T
411	0	0	238	168	0	0	406	C
413	0	0	398	1	0	0	399	C
415	0	0	0	236	0	161	397	G
416	0	396	0	1	0	0	397	T
418	0	407	0	0	0	0	407	A
423	1	0	441	0	0	0	442	C
424	0	439	0	2	0	0	441	T
425	1	440	0	0	0	0	441	T
430	1	446	0	0	0	0	447	T
433	456	0	1	0	0	0	457	A
436	458	0	1	0	0	0	459	A
443	0	0	1	467	0	0	468	G
444	465	0	1	0	0	0	466	A
447	0	0	473	1	0	0	474	C
450	0	373	0	0	102	0	475	T
452	206	0	0	259	0	0	465	A
454	0	0	318	0	151	0	469	C
455	0	0	478	1	0	0	479	C
459	488	0	1	0	0	0	489	A
461	0	1	0	493	0	0	494	G
464	499	0	1	0	0	0	500	A
468	0	0	506	1	0	0	507	C
470	503	0	1	0	0	0	504	A
472	1	495	0	0	0	0	496	T
477	0	0	492	1	0	0	493	C
478	0	1	0	495	0	0	496	G
481	0	494	0	2	0	0	496	T
486	0	1	1	505	0	0	507	G
493	0	0	1	513	0	0	514	G
494	516	1	1	0	0	0	518	A
496	519	1	0	0	0	0	520	A
497	517	1	0	0	0	0	518	A
498	1	519	0	0	0	0	520	T
499	2	518	0	0	0	0	520	T
500	0	1	0	518	0	0	519	G
509	2	296	3	0	216	0	517	T
510	0	0	518	0	1	0	519	C
511	0	0	1	517	0	0	518	G
515	294	0	1	227	0	0	522	G
517	1	0	522	0	0	0	523	C
518	521	1	0	0	0	0	522	A
521	522	0	1	0	0	0	523	A
523	0	1	0	521	0	0	522	G
524	0	0	1	520	0	0	521	G
525	1	520	0	0	0	0	521	T
532	0	0	509	1	0	0	510	C
533	505	0	1	0	0	0	506	A
534	0	0	502	1	0	0	503	C
535	1	0	499	0	0	0	500	C
536	1	495	0	1	0	0	497	T
537	1	494	0	0	0	0	495	T
538	2	225	264	0	0	0	491	C
539	0	487	0	1	0	0	488	T
542	259	1	0	226	0	0	486	G
548	1	0	479	0	0	0	480	C
549	1	478	0	1	0	0	480	T
551	0	1	265	0	207	0	473	C
553	0	474	0	1	0	0	475	T
555	470	2	0	0	0	0	472	A
556	0	1	0	469	0	0	470	G
557	1	469	0	1	0	0	471	T
559	0	0	1	462	0	0	463	G
560	0	0	1	459	0	0	460	G
563	455	1	0	0	0	0	456	A
564	0	0	2	450	0	0	452	G
567	0	0	1	435	0	0	436	G
568	234	0	0	200	0	0	434	A
570	1	429	0	0	0	0	430	T
573	424	1	0	0	0	0	425	A
578	0	0	1	422	0	0	423	G
581	415	1	0	0	0	0	416	A
582	0	0	413	1	0	0	414	A
583	413	1	0	0	0	0	414	A
587	1	0	416	0	0	0	417	C
589	0	0	1	409	0	0	410	G
592	212	0	200	0	0	0	412	C
595	0	407	0	1	0	0	408	T
597	0	0	400	1	0	0	401	C
599	1	0	397	1	0	0	399	C
601	2	401	0	0	0	0	403	T
602	0	398	0	1	0	0	399	T
605	1	0	395	0	0	0	396	C
607	0	394	0	2	0	0	396	T
608	1	0	394	0	0	0	395	C
610	0	389	0	1	0	0	390	T
616	0	374	0	1	0	0	375	T
617	374	1	0	0	0	0	375	A
618	0	374	0	1	0	0	375	T
619	374	0	1	0	0	0	375	A
620	200	0	0	176	0	0	376	A
626	366	1	0	0	0	0	367	A
628	0	371	0	1	0	0	372	T
630	0	371	0	1	0	0	372	T
631	0	367	0	1	0	0	368	T
636	358	1	0	0	0	0	359	A
639	161	195	0	0	0	0	356	T
640	0	0	1	352	0	0	353	G
645	1	0	337	0	0	0	338	C
651	1	0	326	0	0	0	327	C
653	149	0	179	0	0	0	328	C
656	1	0	325	0	0	0	326	C
664	329	1	0	0	0	0	330	A
668	325	2	0	0	0	0	327	A
671	0	0	1	322	0	0	323	T
674	0	317	0	2	0	0	319	T
681	1	0	314	0	0	0	315	C
683	1	0	311	0	0	0	312	C
684	148	0	152	0	0	0	300	C
686	0	0	0	300	0	0	300	T
687	0	0	1	297	0	0	298	G
688	297	1	0	0	0	0	298	A
689	0	0	0	154	0	142	296	G
692	0	0	298	0	0	1	299	C
696	300	1	0	0	0	0	301	A
697	0	0	0	302	0	0	302	A
706	6	0	3	0	303	0	312	A
707	0	314	0	0	1	0	315	T
715	1	0	312	0	0	0	313	C
718	312	1	0	0	0	0	313	A
720	0	311	0	1	0	0	312	T
728	305	1	0	0	0	0	306	A
732	0	0	1	306	0	0	307	G
739	0	169	0	133	0	0	302	T
742	293	1	0	0	0	0	294	A
743	1	0	289	0	0	0	290	C
760	1	0	283	0	0	0	284	C
764	0	287	0	1	0	0	288	T
771	0	290	0	1	0	0	291	T
772	0	294	0	1	0	0	295	T
776	157	131	0	0	0	0	288	T
780	1	0	292	0	0	0	293	C
790	299	0	0	0	0	0	299	C
803	0	0	1	297	0	0	298	G
815	0	288	0	1	0	0	289	T
818	0	0	1	295	0	0	296	G
820	1	0	297	0	0	0	298	C
828	0	305	0	2	0	0	307	T
832	312	1	0	0	0	0	313	A
833	309	2	0	0	0	0	311	A
834	311	2	0	0	0	0	313	A
837	0	0	1	312	0	0	313	G
846	0	0	1	324	0	0	325	G
850	0	317	0	1	0	0	318	T
851	2	0	314	0	0	0	316	C
852	0	0	1	311	0	0	312	G
855	1	0	310	0	0	0	311	C
856	1	0	307	0	0	0	308	C
857	1	0	303	0	0	0	304	C
861	296	1	0	0	0	0	297	A
868	0	0	1	289	0	0	290	G
870	0	286	0	2	0	0	288	T
873	2	0	280	0	0	0	282	C
876	1	0	276	0	0	0	277	C
880	0	123	0	143	0	0	266	G
887	1	0	251	0	0	0	252	C
891	0	0	0	239	0	0	239	T
894	122	114	0	0	0	0	236	T
896	0	0	0	234	0	0	234	C
899	230	1	0	0	0	0	231	A
900	230	1	0	0	0	0	231	A
921	0	187	0	1	0	0	188	T
923	0	0	184	0	0	0	184	T
928	179	1	0	0	0	0	180	A
943	77	0	55	0	0	0	132	C
950	0	122	0	1	0	0	123	T
954	115	1	0	0	0	0	116	A
959	0	102	0	1	0	0	103	T
960	100	1	0	0	0	0	101	A
966	0	66	0	0	0	26	92	T
967	3	81	0	0	0	0	84	T
993	0	19	0	1	0	0	20	T
